11111111
10000001
10000001
10P0C0E1
11111111