11111111
100000E1
100C0001
1P000001
11111111